######F###
###### ###
###### ###
###### ###
#   ## ###
# # ## ###
# #    ###
# ########
# ########
#S###
