##########
###### ###
###### ###
###### ###
#   ## ###
# # ## ###
# #    ###
# ########
#F########
#S########
