##########
##########
#####E####
##### ####
#### S ###
##### ####
##########
##########
##########
##########

