##########
##########
#####F####
##### ####
#### S ###
##### ####
##########
##########
##########
##########

