######F###
###### ###
###### ###
###### ###
#   ## ###
# # ## ###
# #    ###
# ####S###
# ########
#S########
